111111111111
1001111C00E1
1000001011T1
101000101101
1C1000000001
11100111C111
1P0000000001
111111111111